#########
#S #    #
#     B #
# # #####
# P #
#####