####################
#P#                #
# # #############  #
# #          #    #
#   ## ##### #### #
 # #   #   # # #  #
#  # ##  # # #  #  #
# ##  # #  #   # # #
# ##### # #  # # # #
# #   # #   #   ## #
# # #   # ## # ## #
# # ##### #   #    #
#       # # #   ## #
 # #### #   # ## # #
#  #   ## ## #  #  #
# #  # #   #  # # #
# # ## # #   ## #  #
# #   #  # # ## ## #
#   #   #  #    #  D
####################